0000000000000000
0==0000==0000==0
====00====00====
0==0000==0000==0
0000000000000000
0000==0000==0000
000====00====000
0000==0000==0000
0000000000000000
0==0000==0000==0
====00====00====
0==0000==0000==0